1111111111
1000110000
1100011011
1101111011
1000110001
1000000001
1001010001
1001000101
1000000101
1111111111